2 2 2 2 2 2 2 2 2 2 2 2 2 2 2 2 2 2 2 2 2 1 2
2 2 2 2 2 2 2 2 2 2 2 2 2 2 2 2 2 2 2 2 2 1 2
2 2 4 4 4 4 2 2 2 1 1 1 1 2 9 1 1 4 4 4 4 1 2
2 4 4 4 4 4 4 4 2 1 2 7 7 7 7 7 1 4 4 4 9 1 2
2 4 4 4 4 4 4 4 2 1 9 7 7 7 7 7 1 2 4 4 1 1 2
9 2 4 4 4 4 4 4 2 1 2 7 7 7 7 9 1 1 9 2 1 4 4
2 2 2 2 9 4 4 4 2 1 2 7 7 7 7 7 9 1 1 1 1 4 4
1 1 1 1 1 1 1 2 2 1 2 7 7 7 7 7 2 7 7 1 1 2 2
2 7 7 2 2 2 1 1 1 1 2 7 7 7 7 7 2 7 7 1 2 4 4
2 7 7 2 2 7 7 7 7 1 2 2 2 2 7 7 2 2 2 1 2 4 4
2 2 2 9 2 7 7 7 7 1 1 1 4 4 4 2 9 2 2 1 2 4 4
2 2 9 2 2 7 7 7 2 2 2 1 4 4 4 2 2 2 1 1 9 4 4
2 2 2 2 2 7 7 7 2 2 9 1 1 1 1 1 1 1 1 9 2 2 2